NO ./textures/NO.xpm
SO ./textures/SO.xpm
WE ./textures/WE.xpm
EA ./textures/EA.xpm

F 20,20,200
C 200,200,200

11
11111
10001
10N0111
111000111
  1110001
   100011
 1110011
1100011
100011
10101
10101
10001
11111




11111
10001
10S0111
111000111
  1110001
   100011
 1110011
1100011
100011
10101
10101
10001
11111
