NO ./textures/NO.xpm
SO ./textures/SO.xpm
WE ./textures/WE.xpm
EA ./textures/EA.xpm

F 220,20,60
C 0,30,200

111111
111011
100N1
11111

111111
100001
100001
111111
