NO ./textures/2.xpm
SO ./textures/2.xpm
WE ./textures/1.xpm
EA ./textures/1.xpm

F 32,32,32
C 64,210,210

11111
10S01
1000111
111000111
  1110001
   100011
 1110011
1100011
100011
10101                11111111
10101              111000000111
100011           111000000000011
1000011         11000001111000011
11000011      1100000111111000011
110000111    1100000111  11000011
 11000001111110000011   11000011
  1111000011110001111   11000011
	 11000000000011    11000011
	  111000000111     11000011
	    11111111       11000011
					   11000011
   1111111111        111000011
  110000000011      110000111
  1000111000011    110000011
  1110001110001111110000011
	1100011100100001000011
	 11000111000100001011
	  110001111111111111
	   11111
