NO ./textures/NO.xpm
SO ./textures/SO.xpm
WE ./textures/WE.xpm
EA ./textures/EA.xpm

F 220,100,0
C 225,30,0

        1111111111111111111111111
        1000000000110000000000001
        1011000001110000000000001
        1001000000000000000000001
111111111011000001110000000000001
100000000011000001110111111111111
111101111111110111000000100011
111101111111111011101010010001
1100000011010101110000001000111111111
10000000000000001100000010001   10111
10000000000000001101010010001   10101
11000001110101011111011110N0111111101
11110111 1110101 10111101000000000001
11111111 1111111 11111111111111111111