NO ./textures/NO.xpm
SO ./textures/SO.xpm
WE ./textures/WE.xpm
EA ./textures/EA.xpm

F 20,20,200
C 200,200,200

1111111111111111111111111111111111111111111111111111111111111111111
110E000000000000000000000000000000000000000000000000000000000000011
1100000000000000000000000000000000000000000000000000000000000000011
1111111111111111111111111111111111111111111111111111111111111111111