NO ./textures/NO.xpm
SO ./textures/SO.xpm
WE ./textures/WE.xpm
EA ./textures/EA.xpm

F 220,100,-20
C 0,30,220

111111
111011
100001
10N001
111111
